[
    {
        "type": "mapgen",
        "method": "json",
        "weight": 1000,
        "om_terrain": [ 
            [ "tc_Prison1secondfloor_3", "tc_Prison1secondfloor_2", "tc_Prison1secondfloor_1" ],
            [ "tc_Prison1secondfloor_6", "tc_Prison1secondfloor_5", "tc_Prison1secondfloor_4" ],
            [ "tc_Prison1secondfloor_9", "tc_Prison1secondfloor_8", "tc_Prison1secondfloor_7" ]
        ],
        "object": {
            "fill_ter": "t_floor",
            "rows": [
                
                "                                                                        ",
                "                                       .....                            ",
                "                                       .....                            ",
                "                                       .....                            ",
                "                                       .....                            ",
                "                                                                        ",
                "                                                                        ",
                "                                                                        ",
                "                                                 ...............        ",
                "                                                 ...............        ",
                "                                                 ...............        ",
                "                                                 ...............        ",
                "                                                 ...............        ",
                "                                                 ...............        ",
                "                                                 ...............        ",
                "                                                 ...............        ",
                "                                                 ...............        ",
                "                                                 ...............        ",
                "                                                 ..........             ",
                "                                                 ..........             ",
                "                                                 ..........             ",
                "                                                 ..........             ",
                "                                                 ..........             ",
                "                                      .......................           ",
                "                                      .......................           ",
                "                                      .......................           ",
                "                                      ....|||||gg|||||gg|||||           ",
                "                                      ....|T,,B,,B,<,B,,B,,T|           ",
                "                                      ....|,,,G,,B,,,B,,G,,,|           ",
                "                                      ....|bb,B,,BBGBB,,B,bb|           ",
                "                                      ....|||||,,,,,,,,,|||||           ",
                "                           ...............|T,,B,,,,,,,,,B,,T|           ",
                "                           ...............|,,,G,,^^^^^,,G,,,|           ",
                "                           ...............|bb,B,,v   v,,B,bb|           ",
                "                           ...............|||||,,v   v,,|||||           ",
                "         ...........       ||g|g||||||....|T,,B,,v   v,,B,,T|           ",
                "         ...........       |,,,,,|,<,|....|,,,G,,v   v,,G,,,|           ",
                "         ...........       |,,h,,|,,,|....|bb,B,,v   v,,B,bb|           ",
                "         ...........       g,h,h,|BGB||gg||||||,,v   v,,|||||           ",
                "         ...........       |,h,h,|,,,,,,,,B,,,,,,v   v,,B,,T|           ",
                "         ..................|,,h,,+,,,,,,,,G,,,,,,v   v,,G,,,|           ",
                "         ..................g,,,,,g,,,,,,,,B,VN,,,v   v,,B,bb|           ",
                "         ..................|K,,,,|,,,||GB||||||,,v   v,,|||||           ",
                "         ..................|K,oo,|,,,|,,,K|T,,B,,v   v,,B,,T|           ",
                "         ..................|||||||,,,|,,,,|,,,G,,v   v,,G,,,|           ",
                "         ..................|,,,,,B,,,|,tt,|bb,B,,v   v,,B,bb|           ",
                "         ..................g,E,E,B,,,|htth|||||,,v   v,,|||||           ",
                "         ..................g,,,,,G,,,||||||T,,B,,v   v,,B,,T|           ",
                "         ..................|3,,,,B,,,|hh,,|,,,G,,v   v,,G,,,|           ",
                "         ..................|3,33,|,,,+,,,,|bb,B,,v   v,,B,bb|           ",
                "         ..................g,,,,,|,,,|,,,h|||||,,v   v,,|||||           ",
                "         ..................g,E,E,|,,,|,,tt|T,,B,,v   v,,B,,T|           ",
                "         ..................|,,,,,|,,,|K,tt|,,,G,,v   v,,G,,,|           ",
                "         ..................||g|||||+||K,,h|bb,B,,v   v,,B,bb|           ",
                "         ......................|ooo,,||gg||||||,,v   v,,|||||           ",
                "         ......................|,,,,,|....|T,,B,,v   v,,B,,T|           ",
                "         ......................|,,,,,|....|,,,G,,^^^^^,,G,,,|           ",
                "         ......................|h,h,h|....|bb,B,,,,,,,,,B,bb|           ",
                "         ......................|t,t,t|....|||||,,,,,,,,,|||||           ",
                "         ......................|g|g|g|....|T,,B,,BBGBB,,B,,T|           ",
                "         ......................       ....|,,,G,,B,,,B,,G,,,|           ",
                "         ......................       ....|bb,B,,B,<,B,,B,bb|           ",
                "                                      ....|||||gg|||||gg|||||           ",
                "                                                                        ",
                "                                                                        ",
                "                                                                        ",
                "                                                                        ",
                "                                                                        ",
                "                                                                        ",
                "                                                                        ",
                "                                                                        ",
                "                                                                        "
            ],
	"place_monsters": [
        { "monster": "GROUP_ZOMBIE_PRISON", "x": [ 28, 47 ], "y": [ 48, 52 ], "density": 0.2 },
	{ "monster": "GROUP_ZOMBIE_PRISON", "x": [ 32, 36 ], "y": [ 54, 58 ], "density": 0.2 },
	{ "monster": "GROUP_ZOMBIE_PRISON", "x": [ 43, 47 ], "y": [ 48, 61 ], "density": 0.2 },

	{ "monster": "GROUP_ZOMBIE_PRISON", "x": [54, 59 ], "y": [ 48, 61 ], "density": 0.2 },
	{ "monster": "GROUP_ZOMBIE_COP", "x": [48, 55 ], "y": [ 48, 61 ], "density": 0.2 },


	{ "monster": "GROUP_ZOMBIE_PRISON", "x": [28, 47 ], "y": [ 39, 47 ], "density": 0.2 },
	{ "monster": "GROUP_ZOMBIE_PRISON", "x": [43, 47 ], "y": [ 27, 37 ], "density": 0.2 },

	{ "monster": "GROUP_ZOMBIE_PRISON", "x": [ 54, 59 ], "y": [ 27, 47 ], "density": 0.2 },
	{ "monster": "GROUP_ZOMBIE_COP", "x": [ 48, 55 ], "y": [ 27, 31 ], "density": 0.2 }


      ],
        "palettes": [ "tc_prison_palette" ],
	"terrain": { " ": "t_open_air" }
    }
}
]