[
    {
        "type": "mapgen",
        "method": "json",
        "weight": 1000,
        "om_terrain": [ 
            [ "tc_Prison1_roof_3", "tc_Prison1_roof_2", "tc_Prison1_roof_1" ],
            [ "tc_Prison1_roof_6", "tc_Prison1_roof_5", "tc_Prison1_roof_4" ],
            [ "tc_Prison1_roof_9", "tc_Prison1_roof_8", "tc_Prison1_roof_7" ]
        ],
        "object": {
            "fill_ter": "t_floor",
            "rows": [
                
                "                                                                        ",
                "                                       .....                            ",
                "                                       .....                            ",
                "                                       .....                            ",
                "                                       .....                            ",
                "                                                                        ",
                "                                                                        ",
                "                                                                        ",
                "                                                                        ",
                "                                                                        ",
                "                                                                        ",
                "                                                                        ",
                "                                                                        ",
                "                                                                        ",
                "                                                                        ",
                "                                                                        ",
                "                                                                        ",
                "                                                                        ",
                "                                                                        ",
                "                                                                        ",
                "                                                                        ",
                "                                                                        ",
                "                                                                        ",
                "                                                                        ",
                "                                                                        ",
                "                                                                        ",
                "                                          ...................           ",
                "                                          ...................           ",
                "                                          ...................           ",
                "                                          ...................           ",
                "                                          ...................           ",
                "                                          ...................           ",
                "                                          ...................           ",
                "                                          ........~~~........           ",
                "                                          ........~~~........           ",
                "                           ...........    ........~~~........           ",
                "                           ...........    ........~~~........           ",
                "                           ...........    ........~~~........           ",
                "                           .......................~~~........           ",
                "                           .......................~~~........           ",
                "                           .......................~~~........           ",
                "                           .......................~~~........           ",
                "                           .......................~~~........           ",
                "                           .......................~~~........           ",
                "                           .......................~~~........           ",
                "                           .......................~~~........           ",
                "                           .......................~~~........           ",
                "                           .......................~~~........           ",
                "                           .......................~~~........           ",
                "                           .......................~~~........           ",
                "                           .......................~~~........           ",
                "                           .......................~~~........           ",
                "                           .......................~~~........           ",
                "                           .......................~~~........           ",
                "                               ...................~~~........           ",
                "                               .......    ........~~~........           ",
                "                               .......    ...................           ",
                "                               .......    ...................           ",
                "                               .......    ...................           ",
                "                               .......    ...................           ",
                "                                          ...................           ",
                "                                          ...................           ",
                "                                          ...................           ",
                "                                                                        ",
                "                                                                        ",
                "                                                                        ",
                "                                                                        ",
                "                                                                        ",
                "                                                                        ",
                "                                                                        ",
                "                                                                        ",
                "                                                                        "
            ],
        "terrain": { ".": "t_flat_roof", "~": "t_glass_roof", " ": "t_open_air" }
        }
    }
]